20
20
####e###############
#.............#....#
#.#########.#.#.#..#
#....#......#.###.##
####.#.######.#....#
#.#..#.#.#....#.##.#
#.##.#.#.#.####.#..#
#..#.....#......#.##
##.#####.####.###..#
#..#...#.#....#.####
#.##.#.#.####.#....#
#....#.#.#....#.##.#
######.#.#.####.#..#
#.#....#.#..#...#.##
#...#.##.##.#.###..#
#.###.#.....#.#.##.#
#.#...#######.#....#
#.#####.#...#.#.####
#.........#...#....#
